#########################
#.#.#.#............######
#.#...#.####.#####.######
#.#.#...#....#.....####.#
#.#.#####.####.###.#....#
#.#.#...#......#.#.#.#..#
#.....#....#.#.#.#.###.##
##########.#.#.#.#...#.##
#..#.....#.#.#...###.#.##
#..##.##...####.##...#.##
#.###.######.........#.##
#.###...###########..#..#
#...#.#.#............##.#
###.#.############.####.#
#.....##.#.....#.....##.#
#######..#.###.#####.##.#
###...#..#.###.....#.#..#
###!.......#######......#
#########################