#########################
#.#.#.#............#...##
#.#...#.####.#####.#!#..#
#.#.#...#....#.....####.#
#.#.#####.####.###.#....#
#.#.#...#......#.#.#.#..#
#.....#....#.#.#.#.###.##
##.#######.#.#.#.#...#.##
#..#.....#.#.#...###.#.##
#..##.##...#####.#...#.##
#.###.######.........#.##
#.###...###########..#..#
#...#.#..............##.#
###.#.#..#########.####.#
#.....#..#.....#.....##.#
#####.#....###.#####.##.#
###...#..#####.....###..#
###......#########......#
#########################