#########################
# #.#.#.......E....#   ##
# #.E.#.####.#####.#!#  #
# #.#...#....#.....#### #
# #.#####.####.###.#    #
# #.#...#......#.#.# #  #
#  ...#....#.#.#.#.### ##
## #######.#.#.#.#...# ##
#  #.....#.#.#...###.# ##
#  ##.##...#####.#...# ##
# ###.######...E.....# ##
#.###...###########..#  #
#...#.#..............## #
###.#.#..#########.#### #
#..E..#..#     #.....## #
#####.#..  ### #####.## #
###...#..#####     ###  #
###......#########      #
#########################