#########################
# #   #    ###!....##...#
#   # # ## #.#####....#.#
### #   #....#..#.#####.#
#.# #####.####.#...#....#
#.#.#...#......#.#.#.#..#
#.....#....#.#.#.#####.##
##########.#.#.#.#...#.##
#..#.....#E#.#...###...##
#..##.##...#######...#.##
#.###.######.....#...####
#.###...######.####..#..#
#...#.#.#............##.#
###.#.#######.####.####.#
#.....##.#.....#.....##.#
####.##..#.###.#####.##.#
###...#..#.###.....#.#..#
###....E...#######.E....#
#########################