#########################
#...##...####....######!#
#.#....#......##..#####.#
#...##.##.E..###.####...#
##.###.##.....##.####.#.#
##...#.#...E.###......#.#
#..#...#..#######.#####.#
#.###.##.#..........###.#
#........#.####..E..##..#
#.##.#.#.#.####.....##.##
#....#.#...#....##.....##
##.#.#.########.##..#####
#..#.#....#####.##..#####
####.####.#####.##.....##
####.####.......##.##.###
##..............##.##...#
##......E.####.###.######
##.................######
#########################