#########################
#.#...#....###!....##...#
#...#.#.####.#####....#.#
###.#...#....#..#.#####.#
#.#.#####.####.#...#....#
#.#.#...#......#.#.#.#..#
#.....#....#.#.#.#####.##
##########.#.#.#.#...#.##
#..#.....#.#.#...###...##
#..##.##...#######...#.##
#.###.######.....#...####
#.###...######.####..#..#
#...#.#.#............##.#
###.#.#######.####.####.#
#.....##.#.....#.....##.#
####.##..#.###.#####.##.#
###...#..#.###.....#.#..#
###........#######......#
#########################