#########################
#   ##...####....######!#
# #   .#......##..#####.#
#   ##.##.E..###.####...#
## ###.##.....##.####.#.#
##...#.#...E.###......#.#
#..#...#..#######.#####.#
#.###.##.#..........###.#
#........#.####..E..##..#
#.##.#.#.#.####.....##.##
#....#.#...#....##.....##
##.#.#.########.##..#####
#..#.#....#####.##..#####
####.####.#####.##.....##
####.####.......##.##.###
##..............##.##...#
##......E.####.###.######
##.................######
#########################